
R 1083            777
NO ./texture_xpm/WALL1.xpm         
WE  ./texture_xpm/WALL3.xpm 




EA ./texture_xpm/WALL4.xpm       
S          ./texture_xpm/wq.xpm   
SO ./texture_xpm/WALL2.xpm

F     220,100,0
C 225,0,20

        1111111111111111111111111    
        1000000000110002022000001
        1011000001110000002000001 
        100100000010000W000000001  
11111111101100001110000000000001     
100000000011000001111111111111111
11110001111111011100000010001   
1110001111111011101010010001  
11000000110101011100000010001
10000000000000000000000000201
1000000000000001101010010001
1100000111010101111101111000111
11110111 1110101 101111010001
11111111 1111111 111111111111